1111111111111
100000000C001
1000111110011
10010E0000001
1001000010001
1000111110111
111011P000001
1111111111111
