111111111111111111
10000E000000001111
10P000C000P0000011
111111111111111111
