1111111111111111111
10000000C0000001111
1001011111000001111
10010000C0000011111
10010000N0000001111
1000111110110000001
1P011E00000C0000001
1000000000000000001
1001111111100000001
10000000C0000000111
1001C00000000011111
1111111111111111111
